NO textures/black.xpm
SO textures/blue.xpm
WE textures/green.xpm
EA textures/red.xpm

F 220,100,0
C 225,30,0

        1111111111111111111111111
        1000000000110000000000001
        1011000001110000000000001
        100100000000000000N000001
11111111011000001110000000000001
00000000011000001110111111111111
1110111111111011100000010001
1110111111111011101010010001
1000000110101011100000010001
0000000000000001100000010001
0000000000000001101010010001
100000111010101111101111000111
1110111 1110101 101111010001
1111111 1111111 111111111111