NO textures/pt_horror/700_res/wall1/0.xpm textures/pt_horror/700_res/wall1/1.xpm textures/pt_horror/700_res/wall1/2.xpm textures/pt_horror/700_res/wall1/3.xpm textures/pt_horror/700_res/wall1/4.xpm textures/pt_horror/700_res/wall1/5.xpm textures/pt_horror/700_res/wall1/6.xpm textures/pt_horror/700_res/wall1/7.xpm textures/pt_horror/700_res/wall1/8.xpm textures/pt_horror/700_res/wall1/9.xpm textures/pt_horror/700_res/wall1/10.xpm textures/pt_horror/700_res/wall1/11.xpm textures/pt_horror/700_res/wall1/12.xpm textures/pt_horror/700_res/wall1/13.xpm textures/pt_horror/700_res/wall1/14.xpm textures/pt_horror/700_res/wall1/15.xpm textures/pt_horror/700_res/wall1/16.xpm textures/pt_horror/700_res/wall1/17.xpm textures/pt_horror/700_res/wall1/18.xpm textures/pt_horror/700_res/wall1/19.xpm textures/pt_horror/700_res/wall1/20.xpm textures/pt_horror/700_res/wall1/21.xpm textures/pt_horror/700_res/wall1/22.xpm textures/pt_horror/700_res/wall1/23.xpm textures/pt_horror/700_res/wall1/24.xpm textures/pt_horror/700_res/wall1/25.xpm textures/pt_horror/700_res/wall1/26.xpm textures/pt_horror/700_res/wall1/27.xpm textures/pt_horror/700_res/wall1/28.xpm textures/pt_horror/700_res/wall1/29.xpm textures/pt_horror/700_res/wall1/30.xpm textures/pt_horror/700_res/wall1/31.xpm textures/pt_horror/700_res/wall1/32.xpm textures/pt_horror/700_res/wall1/33.xpm textures/pt_horror/700_res/wall1/34.xpm textures/pt_horror/700_res/wall1/35.xpm textures/pt_horror/700_res/wall1/36.xpm textures/pt_horror/700_res/wall1/37.xpm textures/pt_horror/700_res/wall1/38.xpm textures/pt_horror/700_res/wall1/39.xpm textures/pt_horror/700_res/wall1/40.xpm textures/pt_horror/700_res/wall1/41.xpm textures/pt_horror/700_res/wall1/42.xpm textures/pt_horror/700_res/wall1/43.xpm textures/pt_horror/700_res/wall1/44.xpm textures/pt_horror/700_res/wall1/45.xpm textures/pt_horror/700_res/wall1/46.xpm textures/pt_horror/700_res/wall1/47.xpm textures/pt_horror/700_res/wall1/48.xpm textures/pt_horror/700_res/wall1/49.xpm textures/pt_horror/700_res/wall1/50.xpm textures/pt_horror/700_res/wall1/51.xpm textures/pt_horror/700_res/wall1/52.xpm textures/pt_horror/700_res/wall1/53.xpm textures/pt_horror/700_res/wall1/54.xpm textures/pt_horror/700_res/wall1/55.xpm textures/pt_horror/700_res/wall1/56.xpm textures/pt_horror/700_res/wall1/57.xpm textures/pt_horror/700_res/wall1/58.xpm textures/pt_horror/700_res/wall1/59.xpm textures/pt_horror/700_res/wall1/60.xpm textures/pt_horror/700_res/wall1/61.xpm textures/pt_horror/700_res/wall1/62.xpm textures/pt_horror/700_res/wall1/63.xpm

WE textures/pt_horror/700_res/wall4/wall4.xpm

SO textures/pt_horror/700_res/wall2/0.xpm textures/pt_horror/700_res/wall2/1.xpm textures/pt_horror/700_res/wall2/2.xpm textures/pt_horror/700_res/wall2/3.xpm textures/pt_horror/700_res/wall2/4.xpm textures/pt_horror/700_res/wall2/5.xpm textures/pt_horror/700_res/wall2/6.xpm textures/pt_horror/700_res/wall2/7.xpm textures/pt_horror/700_res/wall2/8.xpm textures/pt_horror/700_res/wall2/9.xpm textures/pt_horror/700_res/wall2/10.xpm textures/pt_horror/700_res/wall2/11.xpm textures/pt_horror/700_res/wall2/12.xpm textures/pt_horror/700_res/wall2/13.xpm

EA textures/pt_horror/700_res/wall3/wall3.xpm

DO textures/pt_horror/700_res/door/door.xpm


F 112,112,112
C 32,32,32

111111111111111
100000S00000001
100000000000001
100000000000001
100011DDD110001
100010000010001
1000D00000D0001
100010000010001
10001DDDD110001
100000000000001
100000000000001
100000000000001
111111111111111