NO textures/portal/crystal_box.xpm
SO textures/portal/crystal_imac.xpm
WE textures/portal/crystal.xpm
EA textures/portal/crystal_sign.xpm

F 112,112,112
C 32,32,32

111111111111111
1DDDDDSDDDDDDD1
1DDDDDDDDDDDDD1
1DDDDDDDDDDDDD1
1DDD1DDDDD1DDD1
1DDDDDDDDDDDDD1
1DDDDDDDDDDDDD1
1DDDDDDDDDDDDD1
1DDD1DDDDD1DDD1
1DDDDDDDDDDDDD1
1DDDDDDDDDDDDD1
1DDDDDDDDDDDDD1
111111111111111