NO ../textures/wall1/0.xpm
SO ../textures/wall2/5.xpm
WE ../textures/wall3/wall3.xpm
EA ../textures/wall4/wall4.xpm
DO ../textures/door/door.xpm

F 112,112,112
C 32,32,32

                            11111111
                            10000001
                            10011001
111111111111111111111111    10000001  11111111111111111111
1000000001000000000000011111100000011110000000001100001001
1001000000000000000000000000000010000000000000001100000001
10010000000001111111111100000000100000000111100000000010W1
1001000000000100000000010000010010000000010000000000001001
1001000000000D00000000010000010010000000000010000000000001
10010000000001000000000D000001000000011111111D100000001001
1000000000000100000000010000000000000100000000100000001111
111111000110010000000001000001000000010000000010000001111
1111000000000111111111110000010000000D0000000010000000111
   100000000010000010000000000000000010000000010000000001
   1100000000100000000000000000000000100000000D0000000001
   1100000000D0000010000000000000000011111111110000000001
   110000000010000010000000000000001000000000000000000001
   110000000011111110000000000000000000000000000001000001
   110000110000000000000000000000000000000111111111111111
   1100001100000000000000000000000000001111
   1111111111111111111110000000000001111
                       11111111111111