NO textures/portal/crystal_box.xpm
SO textures/portal/crystal_imac.xpm
WE textures/portal/crystal.xpm
EA textures/portal/crystal_sign.xpm
DO textures/prototype/one.xpm

F 112,112,112
C 32,32,32

11111111111111
10000000000101
10000000000001
10000000000101111
10000000000101101
10000E00000101101
10000000000100001
10000000000101101
10000000000101101
100000000001011D1
11111111111111111