NO textures/portal/crystal_box.xpm
SO textures/portal/crystal_imac.xpm
WE textures/portal/crystal.xpm
EA textures/portal/crystal_sign.xpm

F 112,112,112
C 32,32,32

111111111111111
1E0000000000001
100000000000001
100010000010001
100000000000001
100000000000001
100010000010001
100000000000001
100000000000001
111111111111111