NO textures/portal/crystal_box.xpm
SO textures/portal/crystal_imac.xpm
WE textures/portal/crystal.xpm
EA textures/portal/crystal_sign.xpm

F 112,112,112
C 32,32,32

111111111111111
100000S00000001
100000000000001
100000000000001
10001DDDDD10001
1000D00000D0001
1000D00000D0001
1000D00000D0001
10001DDDDD10001
100000000000001
100000000000001
100000000000001
111111111111111